.....................................................................................
.....................................................................................
.....................................................................................
.....................................................................................
.....................................................................................
.....................................###.............................................
...................D.................###.............................................
.....................................###.................##...###.............#######
..P.......T.....#########...C........###......S.........###...####....G.....#########
###########################################################...#######################