.....................................................................................
.....................................................................................
.....................................................................................
.....................................................................................
.....................................................................................
.....................................###.............................................
...................D.................###.............................................
.....................................###.................##...###.............#######
..P.......E.....#########...C........###................###...####..........#########
###########################################################...#######################